XXXXXXXXXDXXXXXXXXX
X_________________X
X______________P__X
X_________________X
X_________________X
D_____B____B______D
X__________B______X
X__________B______X
X_________________X
X_________________X
XXXXXXXXXDXXXXXXXXX