XXXXXXXXXDXXXXXXXXX
X_________________X
X________B________X
X_________________X
X_________________X
D__B___________B__D
X_________________X
X_________________X
X________B________X
X_________________X
XXXXXXXXXDXXXXXXXXX