XXXXXXXXXXXXXXXXXXX
XC_______________CX
X__XX_________XX__X
X__XX_________XX__X
X_________________X
D_________________D
X_________________X
X__XX_________XX__X
X__XX_________XX__X
XC_______________CX
XXXXXXXXXXXXXXXXXXX