XXXXXXXXXXXXXXXXXXX
X_________________X
XXXXXXXXXXXXXXXXXXX
X________P________X
X_________________X
D_________________D
X_________________X
X________P________X
XXXXXXXXXXXXXXXXXXX
X_________________X
XXXXXXXXXXXXXXXXXXX