XXXXXXXXXDXXXXXXXXX
X_________________X
X_P_______________X
X_________________X
X_________________X
X________B________D
X_________________X
X_________________X
X_P_______________X
X_________________X
XXXXXXXXXDXXXXXXXXX