XXXXXXXXXDXXXXXXXXX
XXX_______________X
XX________________X
X_________________X
X_________________X
D_________________X
X_________________X
XXXXXXXXXX________X
X_S_______________X
XXXXXXXXXXXXXXXXXXX
XXXXXXXXXXXXXXXXXXX