XXXXXXXXXDXXXXXXXXX
XXX_____________XXX
XX_______________XX
X_________________X
X_________________X
XC________________D
X_________________X
X_________________X
XX_______________XX
XXX______C______XXX
XXXXXXXXXXXXXXXXXXX