XXXXXXXXXDXXXXXXXXX
X________________SX
X__________X______X
X__________X______X
X__________X______X
D__________X______X
X__________X______X
X__________X______X
X__________X______X
X________________SX
XXXXXXXXXDXXXXXXXXX