XXXXXXXXXXXXXXXXXXX
X_________________X
X_P_______________X
X_________________X
X_________________X
X_________________D
X________________XX
X_______________XXX
X______________XXXX
X_____________XXXXX
XXXXXXXXXDXXXXXXXXX