XXXXXXXXXDXXXXXXXXX
X_________________X
X_P_____________P_X
X_________________X
X_________________X
X_________________X
X_________________X
X_________________X
X_P_____________P_X
X_________________X
XXXXXXXXXDXXXXXXXXX