XXXXXXXXXDXXXXXXXXX
X_________________X
X____________S____X
X_________________X
X_________________X
X_________________D
X_________________X
X__S______________X
X_________________X
X_________________X
XXXXXXXXXXXXXXXXXXX