XXXXXXXXXXXXXXXXXXX
XB________________X
X_________________X
X_________________X
X_________________X
D_________________D
X_________________X
X_________________X
X_________________X
X________________BX
XXXXXXXXXXXXXXXXXXX