XXXXXXXXXDXXXXXXXXX
XX_______________XX
X_________________X
X_________________X
X_________________X
X________$________X
X_________________X
X_________________X
X_________________X
XX_______________XX
XXXXXXXXXXXXXXXXXXX