XXXXXXXXXDXXXXXXXXX
XX_______________XX
X_________________X
X_________________X
X_________________X
D________$________D
X_________________X
X_________________X
X_________________X
XX_______________XX
XXXXXXXXXDXXXXXXXXX