XXXXXXXXXXXXXXXXXXX
XX_______________XX
X_________________X
X_________________X
X_________________X
X________$________D
X_________________X
X_________________X
X_________________X
XX_______________XX
XXXXXXXXXXXXXXXXXXX