XXXXXXXXXXXXXXXXXXXX                             
X__________________X
X_XX_______________X
X_XX_______________X
X__________________X
X__________________X
X__________________X
X__________________X
X______________X___X
X__________________X
X__________________X
XXXXXXXXXXXXXXXXXXXX
                
                                   
                                   
