XXXXXXXXXXXXXXXXXXX
X_________________X
X__XX_____________X
X__XX_____________X
X_________________X
D_________________D
X_________________X
X_________________X
X______________X__X
X_________________X
XXXXXXXXXXXXXXXXXXX