XXXXXXXXXXXXXXXXXXX
X_________________X
X_XX______________X
X_XX______________X
X_________________X
X_________________X
X_________________X
X_________________X
X______________X__X
X_________________X
XXXXXXXXXXXXXXXXXXX
                
                                   
                                   
