XXXXXXXXXXXXXXXXXXXX                             
X__________________X
X___S__________S___X
X__________________X
X__________________X
X__________________X
X__________________X
X__________________X
X__________________X
X________C_________X
X__________________X
XXXXXXXXXXXXXXXXXXXX
                
                                   
                                   
