XXXXXXXXXDXXXXXXXXX
X_________________X
X_________________X
X_________________X
X_________________X
D_________________X
X_________________X
X_________________X
X_______________P_X
X_________________X
XXXXXXXXXXXXXXXXXXX