XXXXXXXXXDXXXXXXXXX
XC________________X
X__XX_________XX__X
X__XX_________XX__X
X_________________X
X_________________X
X_________________X
X__XX_________XX__X
X__XX_________XX__X
X________________CX
XXXXXXXXXDXXXXXXXXX