XXXXXXXXXDXXXXXXXXX
XB________________X
X_________________X
X_________________X
X_________________X
X_________________X
X_________________X
X_________________X
X_________________X
X________________BX
XXXXXXXXXDXXXXXXXXX