XXXXXXXXXDXXXXXXXXX
X_________________X
X__XX_________XX__X
X__XX_________XX__X
X_________________X
X___S_________S___X
X_________________X
X__XX_________XX__X
X__XX_________XX__X
X_________________X
XXXXXXXXXDXXXXXXXXX