XXXXXXXXXDXXXXXXXXX
X_P_X_________X_P_X
X___X_________X___X
X___X_________X___X
X_________________X
X_________________X
XXXX___________XXXX
X_________________X
X_P_____________P_X
X_________________X
XXXXXXXXXDXXXXXXXXX