XXXXXXXXXXXXXXXXXXX
X_________________X
X_________________X
X_________________X
X_________________X
D________S________D
X_________________X
X_________________X
X_________________X
X_________________X
XXXXXXXXXXXXXXXXXXX