XXXXXXXXXXXXXXXXXXX
X_________________X
X_________________X
X_________________X
X_________________X
D________P________D
X_________________X
X_________________X
X_________________X
X_________________X
XXXXXXXXXXXXXXXXXXX