XXXXXXXXXDXXXXXXXXX
X_________________X
X_________________X
X_______XXX_______X
X______XXXXX______X
D______XXXXX______D
X______XXXXX______X
X_______XXX_______X
X_________________X
X_________________X
XXXXXXXXXDXXXXXXXXX