XXXXXXXXXDXXXXXXXXX
XXXX___________XXXX
XXX_____________XXX
XX_______________XX
X_________________X
D_________________D
X_________________X
XX_______________XX
XXX_____________XXX
XXXX___________XXXX
XXXXXXXXXDXXXXXXXXX