XXXXXXXXXDXXXXXXXXX
XXXX___________XXXX
XXXX___________XXXX
X____P_______P____X
X_________________X
D_________________D
X_________________X
X____P_______P____X
XXXX___________XXXX
XXXX___________XXXX
XXXXXXXXXDXXXXXXXXX