XXXXXXXXXDXXXXXXXXX
X_________________X
X_________________X
X_________________X
X_________________X
D_________________D
X_________________X
X_________________X
X_S_____________P_X
X_________________X
XXXXXXXXXXXXXXXXXXX