XXXXXXXXXDXXXXXXXXX
X_________________X
X__P___________P__X
X_________________X
X_________________X
X_________________X
X_________________X
X_________________X
X__P___________P__X
X_________________X
XXXXXXXXXDXXXXXXXXX