XXXXXXXXXXXXXXXXXXX                    
X_________________X
X_________________X
X________B________X
X_________________X
X_________________X
X_________________X
X_________________X
X_________________X
X_________________X
XXXXXXXXXDXXXXXXXXX