XXXXXXXXXXXXXXXXXXX                    
X_________________X
X_________________X
X_________________X
X_________________X
D______________B__X
X_________________X
X_________________X
X_________________X
X_________________X
XXXXXXXXXXXXXXXXXXX