XXXXXXXXXXXXXXXXXXX                    
X_________________X
X_________________X
X_________________X
X_________________X
X__B______________D
X_________________X
X_________________X
X_________________X
X_________________X
XXXXXXXXXXXXXXXXXXX