XXXXXXXXXXXXXXXXXXX
X________B________X
X________C________X
X_________________X
X_________________X
D_________________D
X_________________X
X_________________X
X________C________X
X________B________X
XXXXXXXXXXXXXXXXXXX