XXXXXXXXXDXXXXXXXXX
X_______X_X___X___X
X___S___X_X_X_X_X_X
X_________X_X_X_X_X
X_XXXXXXXXX_X_X_X_X
X___________X___X_X
X_XXXXXXXXX_XXXXX_X
X_X_________X_____X
X_XXXX_XXXXXX_XXXXX
X___BXSX__________X
XXXXXXXXXDXXXXXXXXX