XXXXXXXXXXXXXXXXXXX
X_________________X
X_________________X
X_________________X
X_________________X
D________C________D
X_________________X
X_________________X
X_________________X
X_________________X
XXXXXXXXXXXXXXXXXXX