XXXXXXXXXDXXXXXXXXX
X_________________X
X__S___________S__X
X_________________X
X_________________X
D_________________D
X_________________X
X_________________X
X________C________X
X_________________X
XXXXXXXXXXXXXXXXXXX