XXXXXXXXXXXXXXXXXXX
X_________________X
X_C_____________C_X
X_________________X
X_________________X
D________B________D
X_________________X
X_________________X
X_C_____________C_X
X_________________X
XXXXXXXXXXXXXXXXXXX