XXXXXXXXXDXXXXXXXXX
X_________________X
X_______________S_X
X_________________X
X_________________X
X_________________X
X_________________X
X_________________X
X_C_______________X
X_________________X
XXXXXXXXXDXXXXXXXXX