xxxxxxxxxxxxxxxxxxxx
xC________________Px
x__________________x
x__________________x
x__________________x
x__________________x
x__________________x
x__________________x
x__________________x
x__________________x
x__________________x
xP_________________x