XXXXXXXXXXXXXXXXXXX
X_________________X
X________S________X
X_________________X
X_________________X
D________X________D
X_________________X
X_________________X
X________S________X
X_________________X
XXXXXXXXXXXXXXXXXXX