XXXXXXXXXDXXXXXXXXX                    
X_________________X
X________S________X
X_________________X
X_________________X
X_________________X
X_________________X
X_________________X
X_________________X
X_________________X
XXXXXXXXXXXXXXXXXXX