XXXXXXXXXXXXXXXXXXX                    
X_________________X
X_________________X
X_________________X
X_________________X
X_________________D
X_________________X
X_________________X
X_________________X
X_________________X
XXXXXXXXXXXXXXXXXXX