XXXXXXXXXXXXXXXXXXX                    
X_________________X
X_________________X
X_________________X
X_________________X
X___C_____________D
X_________________X
X_________________X
X_________________X
X_________________X
XXXXXXXXXXXXXXXXXXX