XXXXXXXXXXXXXXXXXXX                    
X_________________X
X_________________X
X_________________X
X_________________X
D____________P____X
X_________________X
X_________________X
X_________________X
X_________________X
XXXXXXXXXXXXXXXXXXX