XXXXXXXXXXXXXXXXXXX                    
X_________________X
X_________________X
X_________________X
X_________________X
D_________________X
X_________________X
X_________________X
X_________________X
X_________________X
XXXXXXXXXXXXXXXXXXX