XXXXXXXXXDXXXXXXXXX                    
X_________________X
X___S__________S__X
X_________________X
X_________________X
D_________________D
X_________________X
X_________________X
X_________________X
X________C________X
XXXXXXXXXDXXXXXXXXX