XXXXXXXXXDXXXXXXXXX
X_________________X
X________S________X
X_________________X
X_________________X
X________X________X
X_________________X
X_________________X
X________S________X
X_________________X
XXXXXXXXXDXXXXXXXXX